{
    "name":"bigcave.json",
    "width":30,
    "height":15,
    "board":[
        [1, 1, 1, 1, 1, 1, 1, 1, 1, 1, 1, 1, 1, 1, 1, 1, 1, 1, 1, 1, 1, 1, 1, 1, 1, 1, 1, 1, 1, 1],
        [1, 0, 0, 0, 0, 1, 1, 1, 1, 1, 1, 1, 1, 1, 1, 1, 1, 1, 1, 1, 1, 0, 0, 3, 4, 1, 1, 1, 1, 1],
        [1, 0, 0, 1, 0, 0, 1, 1, 1, 0, 0, 0, 0, 0, 0, 0, 1, 1, 1, 1, 0, 0, 4, 4, 1, 1, 1, 1, 1, 1],
        [1, 0, 1, 1, 1, 0, 0, 0, 0, 1, 1, 1, 1, 1, 0, 0, 0, 0, 0, 0, 0, 0, 0, 0, 1, 1, 1, 1, 1, 1],
        [0, 0, 1, 1, 1, 0, 6, 0, 0, 1, 1, 3, 3, 0, 0, 1, 1, 1, 1, 1, 1, 1, 1, 0, 1, 1, 1, 1, 1, 1],
        [0, 0, 0, 1, 1, 0, 0, 6, 0, 1, 3, 4, 3, 1, 1, 1, 1, 1, 1, 1, 1, 1, 0, 1, 1, 1, 1, 1, 1, 1],
        [2, 0, 0, 1, 1, 0, 0, 0, 1, 1, 1, 1, 1, 1, 1, 1, 1, 0, 0, 1, 0, 0, 0, 1, 1, 1, 1, 1, 1, 1],
        [0, 0, 0, 0, 1, 1, 1, 1, 1, 0, 6, 0, 6, 1, 1, 1, 0, 0, 0, 0, 0, 0, 0, 0, 0, 0, 0, 1, 1, 1],
        [1, 1, 1, 0, 0, 1, 1, 1, 1, 0, 0, 6, 0, 0, 0, 1, 0, 0, 0, 0, 3, 3, 3, 3, 3, 3, 3, 1, 1, 1],
        [1, 1, 1, 1, 0, 0, 0, 0, 0, 0, 0, 0, 1, 1, 0, 1, 0, 0, 0, 0, 3, 0, 4, 3, 3, 3, 3, 1, 1, 1],
        [1, 1, 1, 1, 1, 0, 1, 1, 0, 0, 1, 1, 1, 1, 0, 0, 0, 0, 0, 0, 0, 4, 4, 3, 3, 3, 0, 1, 1, 1],
        [1, 1, 0, 0, 0, 1, 1, 1, 1, 1, 1, 3, 3, 1, 1, 1, 0, 0, 0, 3, 0, 4, 0, 3, 0, 1, 1, 1, 1, 1],
        [1, 5, 0, 0, 1, 1, 1, 1, 1, 1, 3, 3, 3, 1, 1, 1, 1, 1, 0, 0, 0, 0, 1, 1, 1, 1, 1, 1, 1, 1],
        [1, 1, 0, 0, 1, 1, 1, 1, 1, 1, 7, 3, 4, 0, 0, 0, 0, 0, 0, 0, 1, 1, 1, 1, 1, 1, 1, 1, 1, 1],
        [1, 1, 1, 1, 1, 1, 1, 1, 1, 1, 1, 1, 1, 1, 1, 1, 1, 1, 1, 1, 1, 1, 1, 1, 1, 1, 1, 1, 1, 1]
    
    ],
    "values":{
        "1":{
            "symbol":"▒▒",
            "behavior":"wall",
            "hitDice":"100",
            "name":"wall"
        },
        "2":"player",
        
        "3":{
            "monster":"rat",
            "code":"3",
            "spawnChance":80,
            "respawnChance":20
        },
        "4":{
            "monster":"direRat",
            "code":"4",
            "spawnChance":60,
            "respawnChance":10
        },
        "5":{
            "monster":"ogre",
            "code":"5",
            "spawnChance":60,
            "respawnChance":5
        },
        "6":{
            "monster":"goblin",
            "code":"6",
            "spawnChance":80,
            "respawnChance":10
        },
        "7":{
            "monster":"chest",
            "code":"7",
            "spawnChance":100,
            "respawnChance":0
        },
        "8":{
            "monster":"wolf",
            "code":"8",
            "spawnChance":90,
            "respawnChance":10
        }
    },
    "destinations":{
        "left":{
            "type":"town"
        }
    }
}